0000000000000000000000000
0111111111111111111111110
0111111111111111111111110
0111111111111111111111110
0111111111111111111111110
0111111111111111111111110
0111111111111111111111110
0111111111111111111111110
0111111111111111111111110
0111111111111111111111110
011Q1W1E1R1T1Y1U1I1O1P110
0111A1S1D1F1G1H1J1K1L1]]0
01111Z1X1C1V1B1N1M1111110
0111111111111111111111110
0111111111111111111111110
0111111111111111111111110
0111111111111111111111110
0111111111111111111111110
0111111111111111111111110
0111111111111111111111110
0111111111111111111111110
0111111111111111111111110
0111111111111111111111110
0111111111111111111111110
0000000000000000000000000