000000000000000000000000000000000000000
011111111111111111111111111111111111110
011111111111123411111111111111111111110
011111111111111111111111111111111111110
011111111111111111111111111111111111110
011111111111111111111111111111111111110
011111111111111111111111111111111111110
011111111111111111111111111111111111110
011111111111111111111111111111111111110
011111111111111111111111111111111111110
011111111111111111111111111111111111110
011111111111111111111111111111111111110
011111111111111111111111111111111111110
011111111111111111111111111111111111110
011111111111111111111111111111111111110
011111111111111111111111111111111111110
011111111111111111111111111111111111110
011111111111111111111111111111111111110
011111111111111111111111111111111111110
011111111111111111111111111111111111110
011111111111111111111111111111111111110
011111111111111111111111111111111111110
011111111111111111111111111111111111110
011111111111111111111111111111111111110
011111111111111111111111111111111111110
011111111111111111111111111111111111110
011111111111111111111111111111111111110
011111111111111111111111111111111111110
011111111111111111111111111111111111110
011111111111111111111111111111111111110
011111111111111111111111111111111111110
011111111111111111111111111111111111110
011111111111111111111111111111111111110
011111111111111111111111111111111111110
01111111Q|W|E|R|T|Y|U|I|O|P|11111111110
011111111111111111111111111111111111110
011111111111111111111111111111111111110
011111111111111111111111111111111111110
011111111111111111111111111111111111110
000000000000000000000000000000000000000