000000000000000111111111111111111111111111111000000000000000
011111111111110111111111111111111111111111111011111111111110
011111111111110111111111111111111111111111111011111111111110
01ABCDEFGHIJK10111111111111111111111111111111011111111111110
01LMNOPQRSTUV10111111111111111111111111111111011121131141110
01111WXYZ111110111111111111111111111111111111011121131141110
011111111111110111111111111111111111111111111011111111111110
011151161171110111111111111111111111111111111011151161171110
011151161171110111111111111111111111111111111011151161171110
011111111111110111111111111111111111111111111011111111111110
011111111111110111111111111111111111111111111011111111111110
011]]]]]]]]]110111111111111111111111111111111011]]]]]]]]]110
011111111111110111111111111111111111111111111011111111111110
011111111111110111111111111111111111111111111011111111111110
000000000000000111111111111111111111111111111000000000000000
