000000000000000111111111111111111111111111111000000000000000
011111111111110111111111111111111111111111111011111111111110
011111111111110111111111111111111111111111111011111111111110
01ABCDEFGHIJK1011111111111111111111111111111101ABCDEFGHIJK10
01LMNOPQRSTUV1011111111111111111111111111111101LMNOPQRSTUV10
01111WXYZ11111011111111111111111111111111111101111WXYZ111110
011111111111110111111111111111111111111111111011111111111110
011111111111110111111111111111111111111111111011111111111110
011111111111110111111111111111111111111111111011111111111110
011111111111110111111111111111111111111111111011111111111110
011111111111110111111111111111111111111111111011111111111110
011]]]]]]]]]110111111111111111111111111111111011]]]]]]]]]110
011111111111110111111111111111111111111111111011111111111110
011111111111110111111111111111111111111111111011111111111110
000000000000000111111111111111111111111111111000000000000000
