100000000000000011111111111111111111111111111000000000000000
101111111111111011111111111111111111111111111011111111111110
101111111111111011111111111111111111111111111011111111111110
101ABCDEFGHIJK101111111111111111111111111111101ABCDEFGHIJK10
101LMNOPQRSTUV101111111111111111111111111111101LMNOPQRSTUV10
101111WXYZ1111101111111111111111111111111111101111WXYZ111110
101111111111111011111111111111111111111111111011111111111110
101111111111111011111111111111111111111111111011111111111110
101111111111111011111111111111111111111111111011111111111110
101111111111111011111111111111111111111111111011111111111110
101111111111111011111111111111111111111111111011111111111110
1011]]]]]]]]]11011111111111111111111111111111011]]]]]]]]]110
101111111111111011111111111111111111111111111011111111111110
101111111111111011111111111111111111111111111011111111111110
100000000000000011111111111111111111111111111000000000000000
