100000000000000011111111111111111111111111111000000000000000
101111111111111011111111111111111111111111111011111111111110
101111111111111011111111111111111111111111111011111111111110
101111111111111011111111111111111111111111111011111111111110
101112113114111011111111111111111111111111111011121131141110
101112113114111011111111111111111111111111111011121131141110
101111111111111011111111111111111111111111111011111111111110
101115116117111011111111111111111111111111111011151161171110
101115116117111011111111111111111111111111111011151161171110
101111111111111011111111111111111111111111111011111111111110
101111111111111011111111111111111111111111111011111111111110
1011]]]]]]]]]11011111111111111111111111111111011]]]]]]]]]110
101111111111111011111111111111111111111111111011111111111110
101111111111111011111111111111111111111111111011111111111110
100000000000000011111111111111111111111111111000000000000000
