000000000000000000000000000000000000000
011111111111111111111111111111111111110
011111111111111111111111111111111111110
011111111111111111111111111111111111110
011111111111111111111111111111111111110
011111111111111111111111111111111111110
011111111111111111111111111111111111110
011111111111111111111111111111111111110
011111111111111111111111111111111111110
011111111111111111111111111111111111110
011111111111111111111111111111111111110
011111111111111111111111111111111111110
011111111111111111111111111111111111110
011111111111111111111111111111111111110
011111111111111111111111111111111111110
011111111111111111111111111111111111110
011111111111111111111111111111111111110
011111111111111111111111111111111111110
011111111111111111111111111111111111110
011111111111111111111111111111111111110
011111111111111111111111111111111111110
011111111111111111111111111111111111110
011111111111111111111111111111111111110
011111111111111111111111111111111111110
011111111111111111111111111111111111110
011111111111111111111111111111111111110
011111111111111111111111111111111111110
011111111111111111111111111111111111110
011111111111111111111111111111111111110
011111111111111111111111111111111111110
011111111111111111111111111111111111110
011111111111111111111111111111111111110
011111111111111111111111111111111111110
011111111111111111111111111111111111110
011111111|Q|W|E|R|T|Y|U|I|O|P|111111110
011111111111111111111111111111111111110
011111111111111111111111111111111111110
011111111111111111111111111111111111110
011111111111111111111111111111111111110
000000000000000000000000000000000000000